11111111111111111111
10P00000000C000000E1
11111111111111111111