1111111111111111111111111111
1C000000000001100000000000C1
1011110111110110111110111101
101111C11111011011111C111101
1011110111110110111110111101
1000P00000000000000000000001
10111101101111111101101111E1
1011110110111111110110111101
1111111111111111111111111111