11111111111
1P000000011
101100C0101
1E1C0001CC1
11111111111
