11111111111
1P000000011
101100C0111
101C0000CC1
11111111111
